###########
#>        #
# ### # ###
#   # #   #
### # ### #
# #X#   # #
# # ##### #
# # #     #
# # # ### #
#     #   #
###########
