###############
#>      #   # #
# ### # # # # #
#     #   #   #
############# #
#   #   #   #X#
# # # # # # # #
# #   #   #   #
# #############
#             #
###############
