#####################                                                                                                                                                                                                                                                          
#>        #     #   #                                                                                                                                                                                                                                                          
# ##### # ### # # # #                                                                                                                                                                                                                                                          
# #     #     #   # #                                                                                                                                                                                                                                                          
# # ############### #
# #   #       # #   #
# ### # ##### # # ###
#     # #   #   # # #
####### # # ### # # #
#       # #     #   #
# # ####### ####### #
# #       # #X    # #
# ####### ### # ### #
# #     #     #     #
# # # # #############
# # # #     #     # #
# ### ##### # ### # #
#   #   # # # #   # #
### ### # # # # ### #
#       #     #     #
#####################
