###########
#>  #     #
# # ### # #
# #     # #
######### #
#    X#   #
# # ### ###
# # #   # #
# # # ### #
# #       #
###########
