###############
#>    #   #   #
# ### # # # ###
#   #   # #   #
### ##### ### #
#   #     #   #
# # # ##### # #
# # #   #   # #
# ##### # # #X#
#     # # # # #
# # # # # # ###
# # # # # #   #
### ### ##### #
#   #   #   # #
# # # ### # # #
# # # #   #   #
# ### # ##### #
# #   # #   # #
# # ### # ### #
#       #     #
###############
